##########
#    #  F#
#    # ###
#        #
#        #
#        #
#        #
#        #
#        #
##########
